#################################################################
######                     ############   ###   #################
####                         ########      #     ################
##                             #######            ###############
###                              #######    ####  ###############
#####              ####         ########  #####  ################
#####              ####        ########   #######################
###                #######    #####     #################   #####
###              ##########   ###     ############           ####
####              ##########       ##########                ####
####                    #################               #########
###                                                           ###
###                                                           ###
###                                                           ###
###                                                          ####
####                                                       ######
####                                                      #######
############                                       ##############
#################################################################
